00000000000000000000
00011111111111000000
00013001000001111000
00013300001120201000
00013301022040001000
00013111200020001000
00011101011100001000
00000001000001111000
00000001111111000000
00000000000000000000