00000000000000000000
00000000000000000000
00000001111110000000
00000001000410000000
00000001002010000000
00000001030010000000
00000001111110000000
00000000000000000000
00000000000000000000
00000000000000000000