00000000000000000000
00011111111110000000
00013000000010000000
00010112111211111000
00014000100000001000
00011110300202001000
00000011100111101000
00000000100300031000
00000000111111111000
00000000000000000000