00000000000000000000
00011111111100000000
00013030000100000000
00013001000111100000
00013031002000110000
00011011000222011000
00001000000200001100
00001000001004000100
00001111111111111100
00000000000000000000