00000001111000000000
00011111001111100000
00010000020200100000
00011020402000100000
00001000001111111000
00001111002000001000
00000001000000001000
00000001111333331000
00000000001111111000
00000000000000000000