00000011111000000000
00111110001111111100
00100000200000003100
00102111020333000100
00100201000030000100
00110000000040111100
00011111111110201000
00000000000010001000
00000000000011111000
00000000000000000000