00000000000000000000
00011111111111111100
00010300201000004100
00010030001020011100
00010203001020110000
00010210300001100000
00010010030011000000
00011111111110000000
00000000000000000000
00000000000000000000