00000000000000000000
00011101111100000000
00010111000111110000
00010000202100011000
00011000000100041000
00001000222001111000
00001111000203331000
00000001110003331000
00000000011111111000
00000000000000000000