00000000000001111100
00001111111111000100
00001004000000000100
00001012110211120100
00001000100000000100
00001000133310001100
00001000000000011000
00001110011111110000
00000011110000000000
00000000000000000000