00000000000000000000
01111111111111111110
01000010000001010010
01020202010000024010
01002101211101110010
01100100020101300010
00100000000333000110
00111111113330000100
00000000011111111100
00000000000000000000