00000000000000000000
00111111111111111100
00130000000000003100
00101111120111110100
00100001024002010100
00101300200100010100
00101110211111110100
00130000000000003100
00111111111111111100
00000000000000000000